############
#@$   $  ..#
###   $##  #
# $  #  #  #
# # ##     #
# $     ##.#
#        ..#
############