##########
#+$      #
# $     .#
# $     .#
##########