##########
#@$    ..#
# $ $   .#
#      ##
#.$ $    #
#.$     .#
##########