#############
#+$        .#
# $  $ $  ..#
# $        .#
#############