##########
#.$    ..#
# $ $  # #
#@  $#####
#.$ $  # #
#.$    ..#
##########