##########
#.$    ..#
# $ $  # #
#+  $# ###
# $ $  # #
#.$    ..#
##########