##########
#@       #
# $      #
#       .#
##########