############
#@$   $  ..#
###$  $##..#
# $  #  #$ #
# # ##$    #
#       ##.#
##       ..#
############