#################
#@      *       #
##    # $ #     #
#    # $.$ #    #
#   # $...$ #   #
#.$  $.....$  $.#
#   $.......$   #
#  $$$$$$$$$$$  #
# *     .     * #
#*     ...     *#
#################