###############
#@        #  ##
###$ #$$ ## ###
# $  # ####  ##
# $ # $ ..... #
# $ $ $#####. #
#        #... #
###############