###############
#.#           #
#.# $ $       #
#.#  $ #### # #
#.# $ $   # # #
#.#  $ ## # # #
#.#     @#   ##
#.#########  ##
#          $  #
#  ############
###############