##################
#            #  .#
# # # #$   # #   #
# # $ $ #   $$...#
# # $ $@$ ## # ..#
#      #     # ..#
##################