###########
#@$     ..#
# $ $   ..#
# $#$#$$..#
# $ $   ..#
# $     ..#
###########