############
#@$      ..#
# $ $    ..#
# $ $  $$..#
# $ $    ..#
# $      ..#
############