##################
#            #  .#
# # # #$   # #  .#
# #   $ #    $  .#
# # # $@$ ## #  .#
#      #     #  .#
##################