############
#@  # # # .#
#   $     .#
# $#$# $$..#
#   $     .#
#   # # # .#
############